00#00000
00###000
0!!!#000
0!!!#000
000##000
00##0000
00#00!!0
00#00!!0