20x16
0,8
10,15
11111111111222222222
11111111111122222222
11111111111122222221
11111111111111112222
11110000000111111222
11000111110111111112
11011111110111111111
11011111110011111111
00011111111011122211
11111121111010000211
11111221111000220211
11112221111112220211
11112211110000220211
11111111110110000211
11111111110111112211
11111111110111111111