8x8:2,0
11011111
11000111
12220111
12220111
11100111
11001111
11011221
11011221