20x15
0,0
7,8
00000000000000000000
11111111111111111110
10000000000000000010
10111111111111111010
10100000000000001010
10101111111111101010
10101000000000101010
10101011111110101010
10101010000000101010
10101011111111101010
10101000000000001010
10101111111111111010
10100000000000000010
10111111111111111110
10000000000000000000