20x15
2,0
6,14
11011111111111111111
11000111111111111111
11110001111111111111
11111100011111111111
11111111011111111111
11111111000111111111
11111111110011111111
11111111111000111111
11111111111110011111
11111111111111011111
11111111111100011111
11111111110001111111
11111111000111111111
11111100011111111111
11111101111111111111