20x15
0,0
7,8
00000000000000000000
11111122211111111110
10000000000000000010
10111111111111111010
10100000000000001010
10101111111111102010
10101000000000102010
20101011111110101010
20101010000000101010
20101011111111101010
20101000000000001010
20101111111111111010
10100000000000000010
10111111111111111110
10000000000000000000