10x10
0,1
3,5
1111111111
0000000001
1111111101
1000000101
1011110101
1010110101
1010000101
1011111101
1000000001
1111111111


