20x15
19,0
5,14
11111111111111111100
11111111111111111001
11111111111111110011
11111111111111100111
11111111111111001111
11111111111110011111
11111111111100111111
11111111111101111111
11111111111101111111
11111111111101111111
11111111111101111111
11111110000001111111
11111100111111111111
11111001111111111111
11111011111111111111
