20x16
9,15
13,0
22222221111110111111
22222221111110111112
22222211111110111122
22222211100000111222
22222211101111111222
22222211101111112222
22222211101111112222
22222211101111122222
22222211101111122222
22222211101112222222
22222211101112222222
22222211101112222222
22222211101112222222
22222211101112222222
22222211101122222222
22222211101122222222