8x8
7,0
1,7
11111100
12211001
12210011
11100111
11001111
10011111
10222111