20x16
13,0
4,15
11111111111110111111
11111111111110111111
11111111111110000111
11111111111111110111
11111111111111110111
11111122222111110221
11111222221110000221
11111122111110111221
11111111111110112221
11111111111110112221
11111111111110112211
11110000002220111211
11110111102220111111
11110111100000111111
11110111111111111111
11110111111111111111