20x15
0,0
1,14
00111111111111111111
10000111111111111111
11110111111111111111
11110000011111111111
11111111011111111111
11111111000001111111
11111111111100000011
11111111111111111001
11111111111111111101
11111111111110000001
11111111000000111111
11110000011111111111
11110111111111111111
10000111111111111111
10111111111111111111