8x7
7,0
1,6
11111100
11111001
11110011
11100111
11001111
10011111
10111111